##########################################################
#@...#...................................................#
#....#...................................................#
##..##...................................................#
#........................................................#
#..................#.....................................#
#........................................................#
#........................................................#
#........................................................#
#........................................................#
#........................................................#
#........................................................#
#........................................................#
#........................................................#
#........................................................#
#........................................................#
#........................................................#
##########################################################

